jenis	NND
monyet	NN
yang	SC
dikerahkan	VB
pemkot	NNP
badan	VB
besar	JJ
,	Z
ekor	NND
panjang	IN
,	Z
dan	CC
milik	VB
wajah	NN
warna	VB
hitam	JJ
.	Z
kedua	CD
orang	NN
kaya	VB
dunia	NN
itu	PR
sudah	MD
hasil	VB
bujuk	VB
banyak	CD
orang	NND
yang	SC
sangat	RB
kaya	VB
di	IN
amerika	NNP
agar	SC
sumbang	VB
paruh	CD
kaya	VB
mereka	PRP
.	Z
hanya	RB
butuh	VB
enam	CD
tahun	NN
bagi	IN
zuckerberg	NNP
untuk	IN
bisa	MD
capai	VB
sukses	VB
seperti	IN
sekarang	NN
ini	PR
,	Z
telah	SC
belum	NEG
-nya	PRP
dia	PRP
luncur	VB
situs	NN
ini	PR
saat	NN
masih	MD
duduk	VB
bagai	IN
mahasiswa	NN
di	IN
universitas	NN
harvard	NNP
.	Z
jamrud	NNP
itu	PR
akhir	VB
sampai	SC
ke	IN
amerika	NNP
,	Z
meski	SC
tiba	VB
di	IN
amerika	NNP
tidak	NEG
jelas	VB
siapa	WH
milik	VB
-nya	PRP
.	Z
sejumlah	NNP
surat kabar	NNP
brasil	NNP
lapor	VB
tiririca	NNP
-	Z
sama	JJ
seperti	IN
satu	CD
dari	IN
puluh	CD
warga	NN
brasil	NNP
buta aksara	JJ
.	Z
universitas	NNP
indonesia	NNP
adalah	NNP	
kampus 	NNP
modern	JJ	
,	Z
komprehensif	JJ
,	Z
buka	VB
,	Z
multibudaya	NN
,	Z
dan	CC
humanis	NN
yang	SC
cakup	VB
disiplin	NN
ilmu	NN
yang	SC
luas	VB
.	Z
di	IN
korea	NNP
selatan	NNP
,	Z
wings	NNP
jadi	VB
album	NNP
laris	NN
di	IN
sejarah	VB
gaon	NNP
album	NNP
chart	NNP
pada	IN
waktu	SC
itu	PR
.	Z
google	NNP
didirikan	VB
oleh	IN
larry	NNP
page	NNP
dan	CC
sergey	NNP
brin	NNP
saat	NN
masih	MD
mahasiswa	NN
ph.d.	NNP
di	IN
universitas	NN
stanford	NNP
.	Z
berhubung	NNP
monyet	NN
adalah	VB
satwa	NNP
dilindungi	VB
di	IN
india	NNP
,	Z
para	DT
jaga	VB
di	IN
taj	NNP
mahal	JJ
buat	VB
tangan	VB
agar	SC
tidak	NEG
ganggu	VB
kunjung	VB
.	Z
salah	VB
satunya	RB
adalah	VB
takut	VB
nakutinya	RB
dengan	SC
ketapel	NN
.	Z
tak	NEG
cuma	RB
di	IN
taj	NNP
mahal	JJ
,	Z
kawan	NN
monyet	NN
juga	RB
mulai	VB
agresif	JJ
di	IN
new	NNP
delhi	NNP
.	Z
